################
#@.T.....E.....#
#..#######.....#
#..#...........#
#..#....^......#
#..#.+.........#
#..#...........#
#.............X#
################
