############
#@....#....#
#.....#.E..#
#.....#....#
#.....#...X#
############
