##########
#........#
#..E...E.#
#........#
#...T..T.#
#.......X#
##########
