##########
#@.......#
#........#
#..E....#
#.......X#
##########
