##########
#@..T....#
#.######.#
#..E...E.#
####.#####
#...E..T.#
#.......X#
##########
